first_name|last_Name
Ferd|Izaac
Emmett|Tredger
Obadias|Hackworthy
York|Ambrosoli
Onfre|Sharpus
Renato|Baignard
Phillipe|Densie
Wainwright|Mayhew
Lemmy|Allport
Abbott|Brinsford
Hector|Dickings
Bayard|Robinet
Stanley|Swalwell
Sigvard|Ranahan
Ignace|Ertel
Archie|Spadotto
Haley|Grzegorczyk
Mordy|Callaghan
Ivar|MacTeggart
Pascal|Alpe
Alasdair|Murrum
Kermie|Addey
Erny|Hewins
Huntlee|Hairsnape
Boyce|Extal
Mathian|Ryles
Lezley|Bocock
Lou|Perutto
Reidar|Tejada
Sheridan|McPeck
Lennie|Maestro
Sigismund|Threlkeld
Far|How to preserve
Brion|Fishlock
Gerardo|Spain-Gower
Nobie|Pervew
Benny|MacGuigan
Stearn|Fothergill
Nathanil|Menichini
Kennett|Rosling
Trueman|Lineker
Inness|Betancourt
Kaine|Pedican
Allayne|Wrotham
Sansone|Sidon
Virgil|Lampard
Bendick|Goodright
Paolo|Batistelli
Abbe|Blundon
Cristiano|Laughlin
Launce|Sterre
Justis|Giampietro
Killian|Fearnehough
Wyatt|Bayle
Bogart|Castagnet
Davey|Aleswell
Mort|Noblett
Robb|Witts
Garfield|Matzke
Ignace|Scading
Isidor|Albery
Onofredo|Couchman
Hugh|Covey
Christy|Bernardelli
Benoit|Keely
Kermit|Raulin
Sherlocke|Odby
Lisle|Piola
Regan|Beesey
Woodman|Schwanden
Chaunce|Phipard-Shears
Ravi|Dunnico
Chev|Martinets
Rriocard|Snazel
Mannie|Epdell
Meredith|McLucky
Kennan|Pugh
Bryanty|Arno
Giffer|Kew
Clim|Dumblton
Farrell|Persicke
Chevalier|Cruz
Vasili|Mepham
Rab|Minchell
Kaine|Gulliver
Burton|Whisson
Gardie|Shurey
Chet|Fatharly
Danny|Sabbins
Normand|Pristnor
Rafferty|Wollers
Jerrold|Wandrack
Ethelbert|Winskill
Pennie|Giorgioni
Nicola|Klima
Yancy|Sherwen
Natal|Cantera
Oliver|Roston
Pierre|Lett
Connor|Mulles
Jareb|Klosges
Henderson|Walden
Lief|Manning
Glyn|Waddilow
Grady|Whitehurst
Carolus|Deporte
Dmitri|Gillespey
Marvin|Catlin
Sigismond|Faveryear
Ernesto|Hurrion
Noll|Oughton
Rowen|Mee
Sheffie|Kubek
Caryl|Maffioni
Hershel|Scanderet
Conrade|Fitzjohn
Dwayne|Yakushkev
Claiborn|Milnes
Conrad|Wilfling
Kinsley|Sansam
Lombard|Aristide
Valdemar|Pringell
Horacio|Goymer
Oliver|Bambury
Gardener|Batt
Devlin|MacVanamy
Randy|Lamb
Noah|McKennan
Francisco|Tomkowicz
Kellen|Whitehorne
Boote|Benez
Gabi|Iggalden
Wolfy|Housecraft
Carmine|Jurisch
Hadley|Isacq
Shaun|Gettens
Jamesy|Senten
Harris|Pavey
Avery|Moorcroft
Giovanni|Kleinert
Drud|Gettings
Tuck|Collick
Read|Holdforth
Dean|Mowen
Steven|Saunt
Smith|Kerwin
Hilliard|Stavers
Riordan|Hablet
Dmitri|Pibworth
Lenci|Confait
Graig|Muskett
Bord|Mitham
Theodore|Kobelt
Buck|De Giorgio
Kev|Crispin
Windham|Brinicombe
Rusty|Callen
Guthry|Glas
Ikey|Beckett
Thibaut|Bligh
Lawton|Gorling
Patten|Theodoris
Augustine|Revely
Huey|Eagar
Paxton|Bushel
Woodrow|Fermor
Gilbert|Spuner
Ansel|Clee
Anatollo|Gook
Arlan|Quinet
Sarge|Kuhwald
Taite|Faye
Algernon|Darrell
Urson|McBayne
Waring|Sargeaunt
Casar|McKnockiter
Michel|Kovalski
Lazar|Illiston
Berton|Davitt
Bertram|Petty
Umberto|Bulfit
Patin|Duinkerk
Cheston|Cast
Billie|Paulucci
Ezekiel|Danielis
Bo|Slayny
Jase|Gasparro
Hartley|Columbine
Ransom|Kennea
Jack|Aguirrezabala
Dom|Cosins
Bernarr|Petriello
Bayard|Lammerich
Andrus|Wegner
Pedro|Woodfine
Curtice|Yezafovich
Karlis|Enocksson
Andrew|Gaven
Evan|Scarr
Marcel|Keiley
Matthaeus|Bellocht
Jerome|Heister
Albrecht|Wortley
Martie|Luter
Cobbie|Sutcliffe
Murdoch|Meany
Felizio|Huggan
Royce|Lening
Thain|Prestland
Cody|Taudevin
Bart|Klimashevich
Chick|Mor
Rodolph|Storrs
Rab|Pedican
Cozmo|Beeke
Derron|Ambroisin
Bruis|Venditti
Shem|Castelli
Shaughn|Brumham
Filmer|Fishley
Em|Rochester
Bourke|Pappin
Etan|Gillooly
Nathanael|Allcroft
Gray|Moulin
Dick|Semrad
Merrill|Shedd
Buddie|MacNucator
Dore|Hastelow
Davy|Ringe
Lindon|Carlick
Blair|Gwioneth
Mycah|Deville
Collin|Giraudot
Patty|Mehmet
Julius|Claybourn
Albrecht|Robbins
Claybourne|Macon
Franzen|Cejka
Giustino|Wabe
Westley|Scranedge
Joey|MacCawley
Abelard|Minmagh
Innis|Fishpoole
Andre|Elstob
Cassius|Bergstram
Panchito|Wrack
Lawry|Yurkiewicz
Clarence|Skedgell
Colin|Cottell
Cecilius|Rolfini
Jordan|Hause
Yancy|Youster
Trace|Cowdray
Nathanil|Boldra
Tamas|Dumberell
Ruy|Beales
Lanie|Whetton
Omar|Kenwyn
Niven|Waber
Inglis|Syne
Schuyler|Wateridge
Mose|Falls
Pieter|Tathacott
Glen|Sayle
Thorvald|Damp
Dukie|Kitteringham
Kristofor|Dargavel
Ethelred|Menci
Fitz|Caughan
Derward|Lemoir
Johny|Vida
Fletch|Priddle
Sigfried|Nassie
Hazlett|Gueinn
Eldon|Halfhide
Urson|Faragan
Randell|Munday
Randall|Fones
Ario|Butchers
Donnell|Shelford
Fremont|Sweed
Osborne|Madison
Clement|Postins
Dall|Hully
Nikita|Luis
Myer|Thickpenny
Patric|Guiver
Purcell|Mulleary
Lucho|Frantzen
Currey|Gilman
Pacorro|Besson
Wendell|Plewes
Skipper|Gorst
Frants|Wolfenden
Sim|Novic
Steffen|Tolomio
Robbert|Gottschalk
Dwight|Abley
Hilarius|Divver
Gardner|Ewer
Zacharias|Gilkes
Abdel|Borne
Orland|Djurisic
Si|Cansfield
Ashlin|Wheal
Erik|MacEntee
Terrel|Haysom
Bailey|Goatman
Bastien|Goane
Sanderson|Cathersides
Schuyler|Sarah
Gerry|McAlinion
Llewellyn|Gerrey
Eduard|Bloyes
Carey|Letrange
Dom|Alvar
Jorgan|Burtt
Lionello|Skelington
Artie|Olivier
Jud|Careswell
Emerson|Greeno
Tadd|Vila
Gabie|Common
Alaric|Gabbitas
Derby|Hullbrook
Eugen|Earwicker
Vasili|Lounds
Aland|Georghiou
Ulysses|Rizzardo
Gay|Beardwood
Tiebout|Pahler
Dicky|Peasee
Brian|Goncalo
Currie|Killiam
Constantino|McKennan
Cyrill|Cowdroy
Sutherland|Seaman
Raimundo|Hobben
Granger|Shakeshaft
Lazar|Lippard
Gerard|Ferrelli
Randall|Hamer
Brucie|Dady
Denys|Meace
Vance|Labeuil
Yardley|Hallaways
Barnard|Vaud
Shermy|Greatbatch
Anders|Bruhnsen
Harmon|Hellin
Merry|Inch
Chucho|Eberdt
Eli|Trahear
Jeramie|Havoc
Clemmie|Swayte
Bevin|Sreenan
Isa|Baldi
Renaldo|Stang-Gjertsen
Carlyle|Farncomb
Prinz|Banat
Erin|Wealthall
Jodie|McFee
Colan|Bernier
Glenden|Shafier
Dal|Bradmore
Obidiah|Cummings
Eliot|Matei
Alexandr|Domino
Haily|Alves
Wang|Messier
Ellswerth|Garwill
Job|Gilbertson
Sancho|Maughan
Alisander|Rosenbloom
Jamesy|Elcock
Vick|Mousley
Lewie|Rahl
Valentino|Lesly
Kevin|Vevers
Zachariah|Blakeman
Holden|Pendergast
Tirrell|Lilion
Sanders|Carnock
Monro|Lidierth
Mortimer|Mattei
Boycey|Searjeant
Humfried|Janaszkiewicz
Theodore|Galer
Noll|Buscher
Ashton|Veck
Georgi|Dando
Germain|Patriche
Zeke|Clutten
Alvy|Bax
Granny|O'Shavlan
Dill|Comi
Webster|Pinchen
Moritz|Bohden
Elwin|Sainz
Bill|Sainer
Eugen|Diglin
Chrissie|Doram
Barry|Semple
Alfredo|Morales
Vasilis|Luckman
Kain|Skellion
Waverley|Adshede
Gerrie|Soane
Thorvald|Deary
Zared|Leebetter
Gilbert|Etherson
Filberto|Fathers
Peder|Ragless
Gabriello|Lye
Urbano|Beeton
Thorny|Sale
Don|Everex
Pepito|Singyard
Gardie|Baskett
Culver|Gyorffy
Ebenezer|Madill
Somerset|Pellatt
Elijah|Botha
Evelyn|Cant
Eberto|Hardage
Natale|Lorryman
Guntar|Sabberton
Bartholomew|Dowrey
Noah|Slinn
Barris|Blunsen
Paco|Burkinshaw
Grantham|Bolton
Vern|Carlaw
Chrisse|Boor
Emlyn|Parlett
Cornell|Di Franceshci
Trumaine|Bessent
Tyler|Wallentin
Jamey|Kall
Fons|Siggens
Zerk|Klimkovich
Raffaello|Chisholm
Beau|McQuillin
Barret|Moan
Shelby|Fawdery
Chrisse|Knevet
Tremayne|Cretney
Nicola|Pavel
Kane|Loughnan
Keefe|McKeowon
Arman|Malone
Em|Pickles
Urbano|Swindley
Stephanus|Twigley
Hazlett|Krystek
Lewiss|Vivers
Mervin|Sheircliffe
Eduino|O'Dooghaine
Austin|Rohfsen
Wakefield|Riddeough
Fonzie|Bough
Solly|Gronav
Hakeem|Wigfall
Arne|Essam
Woodie|Escofier
Barnett|Patman
Royce|Iglesias
Killie|Bauldry
Seymour|Hukin
Elvyn|Hinchon
Rowen|Clemencon
Xerxes|Winnard
Troy|Woolger
Brock|Fenna
Wendall|Riceards
Findlay|Stranger
Davon|Cuttings
Ferdy|Shepton
Laurence|Eskrick
Merrel|Pamplin
Rickert|Fountain
Mattie|Palombi
Flin|Aslott
Roderic|Boardman
Jeno|Harpur
Cammy|Arnely
Hale|Hartin
Germain|Schimann
Shepherd|Roomes
Burgess|Denyukhin
Feliks|Christer
Dill|Moulster
Rafaellle|Searles
Corbet|Greenman
Erroll|Dorant
Marc|Brisland
Roderick|Coller
Carrol|Zellner
Nate|Leatt
